SO ./path_to_the_south_texture          
        
        F        220,255,0


        NO              ./path_to_the_north_texture        

C                0,26,77




     WE ./path_to_the_west_texture              

EA     ./path_to_the_east_texture   

1111111111
1100001101
1000000001
1110W00101
1000000001
1111111111


