SO ./path_to_the_south_texture          
        
        F        220,100,0

        NO              ./path_to_the_north_texture     

C                0,0,0




     WE ./path_to_the_west_texture              

EA     ./path_to_the_east_texture   

        1111111111111111111111111
        1000000000110001000010001
        1011001001110001111110001
        100100000000000000000001111
111111111011000001110000000000001    
100000000011000001110111111111111
11110111111111S11100000010001
11110111111111011101010010001
11000000110101011100000010001
10000000000000001100000010001
10000000000000001101010010001
1100000011010101111101111000111
11110111 1110101 101111010001
11111111 1111111 111111111111


