SO ./textures/so.png          
        
        F        3,55,75


        NO              ./textures/no.png        

C                39,188,245




     WE ./textures/we.png              

EA     ./textures/ea.png   

11111111111111111111
10010000000000110001
10010000000000010001
1001000000000000001
100100000W0000000001
10000010000000000001
10000001000000000001
10000000000000000001
11111111111111111111
                1             
                1


