        F        3,55,75

SO ./textures/so.png          
        


        NO              ./textures/no.png        

C                39,188,245




     WE  ./textures/we.png              

EA     ./textures/ea.png   
                                             1                                    1
                                            101                                  101
                                           10001                                10001
                                          1001001                              1001001
                                         1001 1001                            1001 1001
                                        1001   1001                          1001   1001 
                                         1001 1001                            1001 1001
                                          1001001                              1001001
11111111111111111111111111111111111        10001                                10001
1000000000110000000000000000000000011111111110111111111111111111111111111111111111011111111111111111111
10000000001100000000000000000000000000000000000000000000000000000000000000000000000000000000000000S00011
10000000001100000000000000000000000000000000000000000000000000000000000000000000000000000000000000000000111
100000000011000000000000000000000000000000000000000000000000000000000000000000000000000000000000000000100001
1000100000110000000000000000000000011111111111111111111111111111100111111111111111111111111110000000000110001
100000000011000000000000000000000001                            1001                        10000000001  10001
100000000011000000000000000000000001                            1001                        10000000001   10001
100000000011000000000000000000000001                            1001                        10000000001  10001
100000000011000000000000000000000001                            101                         10000000001 10001
100000000011000100000000000000000001                            101                         1000000000010001
100000000011000110000100000000000001                           1101                         100000000000001
100000000000000000001000000000000001                           10001                         1000000000001
100000000000000000000000000000000001                          10001                         1000000000001
100000000000000000000000000000000001   111111111             10011                           11111000001
100000000000000000000000000000000001   100000001            10011                                100001
100000000011000000000000000000000001111100100001            1000011111111                        100001
1000000000110000000000000000000000000000000000011111111111110000000000000111111111111111111111111100001
100000000011000000000000000000000000000000000000000000000000011111111110000000000000000000000000000001111111111111111111111111111111111111111111111111111111111111111111111
1000000000110000000000000000000000011111110011111111111111111          10000000000000000000000000000000000000000000000000000000000000000000000000000000000000000000000000001
100000000011000000000000000000000001111100000001                       1000000001111000000000111110000000000011110000000000001111100000000000111111111111111111111111111001
100000000011000000000000000000000001    10000111111111111111111111111111000000001   100000001     10000000001    100000000001     10000000001                          10001
111111111111111111111111111111111111    11000000000000000000000000000000000000001 11000000001    100000000001    100000000001    100000000001                           10001
                                          100000000000000000000000000000000000001  1111000001     11111000001     11111000001     11111000001                            10001
111111111111111111111111111111111111111111000000000000000000000000000000000000001      100001          100001          100001          100001                           10001
100000000011000000000000000000000000000000000001111111111111111111111111111111111      100001       111000001       111000001          100001                          10001
100000000000000000000000000000000011111111111111                                       100001      1000000001      1000000001          100001                           10001
10000000000000000000000000000000001111                                                 100001       111000001       111000001          100001                            10001
10000000000000000000000000000000000001                                                 100001          100001          100001          100001                           10001
10000000000000000000000000000000000001                                                 100001     11111000001     11111000001          100001                          10001
10000000000000000000000000000000000001                                                 100001    100000000001    100000000001          100001                           10001
1000000000000000000000000000000000000011111111         111111111111111111111111111111110000001111000000000000111100000000000011111111110000001111111111111111111         10001
10000000000000000000000000000000000000000000001       10000000000000000000000000000000000000000000000000000000000000000000000000000000000000000000000000000000001       10001
100000000000000000000000000000000000000000000001     1000000000000000000000000000000000000000000000000000000000000000000000000000000000000000000000000000000000001111111000001
10000000000000000000000000000000000000000000001       10000000000000000000000000000000000000000000000000000000000000000000000000000000000000000000000000000000000000000000001
1000000000000000000000000000000000000000000000011111110000000000000000000000000000000000000000000000000000000000000000000000000000000000000000000000000000000000111111111111
1000000000000000000000000000000000000000000000000000000000000000000000000000000000000000000000000000000000000000000000000000000000000000000000000000000000000001
10000000000000000000000000000000000000000000011111111110000000000000000000000000000000000000000000000000000000000000000000000000000000000000000000000000000000001
100000000000000000000000000000000000000000001          10000000000000000000000000000000000000000000000000000000000000000000000000000000000000000000000000000000001
1000000000000000000000000000000000000000000001        10000000000000000000000000000000000000000000000000000000000000000000000000000000000000000000000000000000001
100000000000000000000000000000000000011111111          111111111111111111111111111110111111111111111111111111111111111111111111111111101111111111111111111111111
10000000000000000000000000000000000001                                            1001                                               101
10000000000000000000000000000000000001                                           1001                                                101
10000000000000000000000000000000000001                                          1001                                                1001
10000000000000000000000000000000000001                                         1001                                                 101
10000000000000000000000000000000000001                                        1001                                                  101
1000000000000000000000000000000000001                                        1001                                                   101
10000000000000000000000000000000000001                                        1001                                                  101
1000000000000000000000000000000000001                                        1001                                                   101
10000000000000000000000000000000000001                                      1001                                                    101
10000000000000000000000000000000000001                                       1001                                                  1001
10000000000000000000000000000000000001                                        1001                                                 101
100000000000000000000000000000000000011                                        1001                                                101
1000000000000000000000000000000000000001                                        1001                                                101
100000000000000000000000000000000000010011                                       1001                                              101
1000000000000000001100000000000000000110001                                       101                                      11111111101
100000000000001111  111100000000000001 1001                                       101                                     100000000001
10000000000001          10000000000001  1001                                      101                                     10111111111
10000000000001          10000000000001   1001                                     101                                     101
10000000000001          10000000000001    1001                                    101                                    1001
10000000000001          10000000000001   1001                                    1101111111111111111111111111111111111111001
10000000000001          10000000000001  1001                                    1100000000000000000000000000000000000000001
10000000000001          10000000000001  101                                    10001111111111111111111111111111111111111111
1000000000000011      1100000000000001  1001111111111111111111111111111111111  1001
10000000000000001   110000000000000001   10000000000000000000000000000000000011001
10000000000000001 11000000000000000001    111111111111111111111111111111111100001
10000000000000000100000000000000000001                                      1001
10000000000000000000000000000000000001                                     1001
10000000000000000000000000000000000001                                      1001
10000000000000000000000000000000000001                                       1001
10000000000000000000000000000000000001                                      1001
10000000000000000000000000000000000001                                       1001
10000000000000000000000000000000000001                                      1001
10000000000000000000000000000000000001                                       1001
10000000000000000000000000000000000001                                        1001
10000000000000000000000000000000000001                                         1001
10000000000000000000000000000000000001                                          1001
10000000000000000000000000000000000001                                           101
 100000000000000000000000000000000001                                             1
  1000000000000000000000000000000001
   10000000000000000000000000000001
    100000000000000010000000000001
     100000000000011 100000000001
      100000000011    1000000001
       100000011       10000001
        100001          100001
         1001            1001
          11              11

